#########
#R..Q..Q#
#.#.#Q#.#
#...#.#.#
#####.#.#
#.Q.Q.#.#
#.#####.#
#..Q..Q.#
#####S###