%%%%%%%%%%%%%%%%%%%%%
%...P ..   ..   ..  %
%. . .... .  . .  . %
%.     .. .  . .  . %
%..   ..  .  . . G. %
%  .   .. .  . .  . %
%. . .... .  . .  . %
%..   ..   ..   .. o%
%%%%%%%%%%%%%%%%%%%%%
